SO     ./render/so.xpm
NO     ./render/no.xpm
WE     ./render/we.xpm
EA     ./render/ea.xpm
F   100,200,300


111111111111111111111111111111111111111111111111111111111111
100000000000000000000000000000000000000000000000000000000001
10000000000000N000000000000000000000000000000000000000000001
100000000000000000000000000000000000000000000000000000000001
111111110000000011111111111111111000000000001111111111111111
       1000000001               1000000000001
       1000000001               1000000000001
       1000000001               1000000000001
1111111000000000011111111111111100000000000001111111111111111111111111111111
10000000000000000000000000000000000000000000000000000000000000000000000000001
100000000000000000000000000000000000000000000000000000000000000000000000000001
10000000000000000000000000000000000000000000000000000001000000000000000000001
1000000000000000000000000000000000000000000000000000001 10000000000000000001
1000000000000000000000000000000000000000000000000000001 1000000000000000001
1000000000000000000000000000000000000000000000000000001 1000000000000000001
1000000000000000000000000000000000000000000000000000001 1000000000000000001
1111111111111111111111111111111111111111111111111111111 111111111111111111
