1111111
1000111
10000N1
1111111