111111111111111111111111111111111111111111111111111111111111
100000000000000000000000000000000000000000000000000000000001
100000000000000000000000000000000000000000000000000000000001
100000000000000000000000000000000000000000000000000000000001
111111110000000011111111111111111000000000001111111111111111
       1000000001               1000000000001
       1000000001               1000000000001
       1000000001               1000000000001
111111100000000001111111111111110000000000000111111111111111111111111111111
1000000000000000000000000000000000000000000000000000000000000000000000000001
1000000000000000000000000000000000000000000000000000000000000000000000000001111111
1000000000000000000000000000000000000000000000000000000000000000000000000001
10000000000000000000000000000000000000000000000000000000000000000000000000W1
111111111111111111111111111111111111111111111111111111111111111111111111111