NO     ./images/north.xpm
SO     ./images/south.xpm
EA     ./images/east.xpm
WE     ./images/west.xpm
F   051,102,000
C   000,000,026


111111111111111111111111111111111111111111111111111111111111
100000000000000000000000000000000000000000000000000000000001
100000000000000000000000000000000000000000000000000000000001
100000000000000000000000000000000000000000000000000000000001
111111110000000011111111111111111000000000001111111111111111
       1000000001               1000000000001
       1000000001               1000000000001
       1000000001               1000000000001
1111111000000000011111111111111100000000000011111111111111111111111111111111
10000000000000000000000000000000000000000000000000000000000000000000000000001
100000000000000000000000000000000000000000000000000000000000000000000000000001
10000000000000000000000000000000000000000000000000000111100000000000000000001
10000000000000000000000000000000E000000000000000000001  10000000000000000001
100000000000000000000000000000000000000000000000000001  1000000000000000001
100000000000000000000000000000000000000000000000000001111000000000000000001
100000000000000000000000000000000000000000000000000000000000000000000000001
11111111111111111111111111111111111111111111111111111111111111111111111111
