SO     ./render/fuwyegfuiyewgfiwefiwviwbeiwuvbiweuvbiweuvbwiuevbiweuvbiweuviwebviwuebviweuvbiwevub/so.xpm
NO     ./render/no.xpm
WE     ./render/we.xpm
EA     ./render/ea.xpm
F   100,200,300


111111111111111111111111111111111111111111111111111111111111
100000000000000000000000000000000000000000000000000000000001
10000000000000N000000000000000000000000000000000000000000001
100000000000000000000000000000000000000000000000000000000001
111111110000000011111111111111111000000000001111111111111111
       1000000001               1000000000001
       1000000001               1000000000001
       1000000001               1000000000001
111111100000000001111111111111110000000000000111111111111111111111111111111
1000000000000000000000000000000000000000000000000000000000000000000000000001
1000000000000000000000000000000000000000000000000000000000000000000000000001111111
1000000000000000000000000000000000000000000000000000000100000000000000000001
1000000000000000000000000000000000000000000000000000001 10000000000000000001
1000000000000000000000000000000000000000000000000000001 1000000000000000001
1000000000000000000000000000000000000000000000000000001 1000000000000000001
1000000000000000000000000000000000000000000000000000001 1000000000000000001
1111111111111111111111111111111111111111111111111111111 111111111111111111
